
F 255,255,255
C 0,0,255

NO  ./textures/brick1.png
WE  ./textures/brick2.png
EA  ./textures/brick3.png
SO  ./textures/brick4.png

11111111111111111111
10000000000000000001
10000000000000000001
1000000000E100000001
10000000001000000001
10000000000000000001
11111111111111111111q