
F  1, 2, 3
C  2, 3, 4

NO  ./textures/0.png
WE  ./textures/1.png
EA  ./textures/2.png
SO  ./textures/3.png

11111111111111111111
10000000000000000001
10000000000000000001
1000000000E100000001
10000000001000000001
10000000000000000001
11111111111111111111