F  1, 	1 ,	1
C		 225	,	30  ,	0
NO  ./Users/adoner/Desktop/before_merge/download.png
WE  ./Users/adoner/Desktop/before_merge/download.png
EA  ./Users/adoner/Desktop/before_merge/download.png
SO  ./Users/adoner/Desktop/before_merge/download.png


11111
10001
10S01
10001
11111