F  1, 	1 ,	1
C		 225	,	30  ,	0
NO  ./Users/adoner/Desktop/before_merge/download.png
WE  ./Users/adoner/Desktop/before_merge/download.png
EA  ./Users/adoner/Desktop/before_merge/download.png
SO  ./Users/adoner/Desktop/before_merge/download.png


11111111111
10000011001
10000100001
10001E10001
10000100001
10000110001
10000001001
11111111111
