
F  12,64,18
C 150 , 206, 233


NO  textures/Sand1.png
WE  textures/Dirt_1png.png
EA  textures/Enviroment.png
SO  textures/Dirt_2.png


11111111111111
11111111000001
11111111101101
11111001000001
1100000N000001
10000000001101
11111111111111