
//input need to work
// 1) ./cub3d null.cube.cube error: wrong extention ->> correct extention

// 2) ./cub3d TEST..cube error: wrong extention ->> correct extention

// 3) ./cub3d maps_variations/TEST.cub hello luoana error: unable to collect all required information ->> wrong number of arguments

//2 (5.50M) ROOT LEAK: 0x7fbbb840e550 [32]
//   1 (5.50M) 0x109d5d000 [5763072]
//
//1 (16 bytes) ROOT LEAK: 0x7fbbb8402840 [16]
//1 (16 bytes) ROOT LEAK: 0x7fbbb84030f0 [16]
//1 (16 bytes) ROOT LEAK: 0x7fbbb840d9d0 [16]
//1 (16 bytes) ROOT LEAK: 0x7fbbb840e480 [16]



--------

+ error in input if after map is no newline - look into into
+ only .cub maps accepted

+ textures path is needed not FD
+ ./bla bla - dot/ is not part of iudentifier

+ only .png files textures are accepted

F  0,0,255
C 255,0,0


NO  textures/0.png
WE   textures/1.png
EA  textures/2.png
SO  fake.png


111111111111111111111111111111111
111111110000000001100000000000001
111111111011000001110000000000001
1111100100000000000000000000111111111111111
111111111011000001110000000000001
100000000011000001110111111111111
111101111111110111000000100011111
111101111111110111010100100011111
11000000110101011100000010001111
10000000000000001100000010W011111
100000000000000011010100100011111
1100001111010101111101111000111
1111011  111010111011110100011111
11 1111  11111111111  11111111111
11  11111111111111111111111111111
1    1110000000001100000000000001
1  111111011000001110000000000001
1111100100000000000000000000111111111111111
111111111011000001110000000000001
100000000011000001110111111111111
111101111111110111000000100011111
111101111111110111010100100011111
11000000110101011100000010001111
100000000000000011000000100011111
100000000000000011010100100011111
1100001111010101111101111000111
1111011 1111010111011110100011111
1111111 1111111111111 11111111111