
F  0,0,0
C 255,255,255


NO textures/set1.png
WE textures/set2.png
EA textures/set3.png
SO textures/set4.png

11111111111111
11111111000001
11111111101101
11111001000001
1100000W000001
10000000001101
11111111111111